NO ./textures/1.xpm
SO ./textures/2.xpm
WE ./textures/3.xpm
EA ./textures/4.xpm

F 220,100,0
C 240,188,255

11111111111111111
10000000000000001
10000000000000001
10000000000000001
100000000E0000001
11111000000000111
11000000000000011
11111111111111111